"filename", "language", "Java", "XML", "comment", "blank", "total"
"/Users/Silverhand/Developer/TrumanCodeSpaces/CS-260/Lab2-Inhertance/TicTacToe/.idea/artifacts/TicTacToe_jar.xml", "XML", 0, 9, 0, 0, 9
"/Users/Silverhand/Developer/TrumanCodeSpaces/CS-260/Lab2-Inhertance/TicTacToe/.idea/codeStyles/Project.xml", "XML", 0, 34, 0, 0, 34
"/Users/Silverhand/Developer/TrumanCodeSpaces/CS-260/Lab2-Inhertance/TicTacToe/.idea/codeStyles/codeStyleConfig.xml", "XML", 0, 5, 0, 0, 5
"/Users/Silverhand/Developer/TrumanCodeSpaces/CS-260/Lab2-Inhertance/TicTacToe/.idea/misc.xml", "XML", 0, 6, 0, 0, 6
"/Users/Silverhand/Developer/TrumanCodeSpaces/CS-260/Lab2-Inhertance/TicTacToe/.idea/modules.xml", "XML", 0, 8, 0, 0, 8
"/Users/Silverhand/Developer/TrumanCodeSpaces/CS-260/Lab2-Inhertance/TicTacToe/.idea/runConfigurations.xml", "XML", 0, 10, 0, 0, 10
"/Users/Silverhand/Developer/TrumanCodeSpaces/CS-260/Lab2-Inhertance/TicTacToe/.idea/vcs.xml", "XML", 0, 6, 0, 0, 6
"/Users/Silverhand/Developer/TrumanCodeSpaces/CS-260/Lab2-Inhertance/TicTacToe/TicTacToe.iml", "XML", 0, 21, 0, 0, 21
"/Users/Silverhand/Developer/TrumanCodeSpaces/CS-260/Lab2-Inhertance/TicTacToe/src/TicTacToeApp.java", "Java", 100, 0, 13, 2, 115
"/Users/Silverhand/Developer/TrumanCodeSpaces/CS-260/Lab2-Inhertance/TicTacToe/src/com/edu/truman/li/cs260/TicTacToe/Board.java", "Java", 114, 0, 40, 10, 164
"/Users/Silverhand/Developer/TrumanCodeSpaces/CS-260/Lab2-Inhertance/TicTacToe/src/com/edu/truman/li/cs260/TicTacToe/CompPlayer.java", "Java", 163, 0, 11, 4, 178
"/Users/Silverhand/Developer/TrumanCodeSpaces/CS-260/Lab2-Inhertance/TicTacToe/src/com/edu/truman/li/cs260/TicTacToe/HumanPlayer.java", "Java", 51, 0, 0, 4, 55
"/Users/Silverhand/Developer/TrumanCodeSpaces/CS-260/Lab2-Inhertance/TicTacToe/src/com/edu/truman/li/cs260/TicTacToe/Player.java", "Java", 22, 0, 0, 2, 24
"Total", "-", 450, 99, 64, 22, 635